100
xxxxxxx###xxxxxxx
xxx#####*######xx
####   . .    ###
#. .   # #   . .#
# . .# # # #. . #
#* . # # # # . *#
######. $ .######
#    # ### #    #
#  . #  .  # .  #
# # .  . .  . # #
# #.  .# #.  .# #
# # ## # # ## # #
#*  .  # #  .  *#
#### . . .  . ###
xxx#####*######xx
xxxxxxx###xxxxxxx
