10
#########
#  .*   #
#$ .   *#
#  .    #
#########
