20
#####
# *.#
# . #
#. .#
# .*#
#. .#
# . #
#   #
#   #
# $ #
#####
