30
#########
#   .   #
#$ .    #
####  ###
#  #    #
#*  ....#
# .   * #
#########
