20
x#####x
##.*.##
#*   *#
#*...*#
## $ ##
x#####x
