20
#######
#$    #
# ... #
# .**.#
#. .. #
#* * *#
#######
