40
#########
#*     *#
#. ... .#
# .   . #
#  . .  #
#*.   .*#
#### ####
xxx# #xxx
xx## ##xx
xx#* *#xx
xx#...#xx
xx# $ #xx
xx#####xx
